####################################################################################################################
#__________________________________________________________________________________________________________________#
#__________________________________________________________________________________________________________________#
#__________________________________________________________________________________________________________________#
#__________________________________________________________________________________________________________________#
#__________________________________________________________________________________________________________________#
#__________________________________________________________________________________________________________________#
#__________________________________________________________________________________________________________________#
#__*_______*__*__*______________****____________**_____________*******___________***************___________________#
####################################################################################################################