####################
#__**______________#
#__________________#
#__________________#
#__________________#
#__________________#
#__________________#
#__________________#
#__*_______________#
####################