####################
#__**______________#
#__________________#
#__________________#
#__________________#
#__________________#
#__________________#
#__________________#
#__________________#
####################